Source:

HONGKONG
1. Hongkong Disneyland: TDR Explorer
2. Lantau Island: Baltana
3. Tsim Sha Tsui: Lacrucci
4. Ocean Park: Wikimedia Commons
5. Madame Tussauds: Madame Tussauds Hong Kong

JAPAN
1. Japan Tokyo Disneyland: The Poor Traveler
2. Mount Fuji: HDQ Walls
3. Universal Studios: Universal Studios
4. Arashiyama: Good Earth Canvas
5. Odaiba: GaijinPot Travel

MALAYSIA
1. Legoland: Atom Travel
2. Petronas: Ask Ideas
3. Sunway Lagoon: Sunway Lagoon
4. Penang Hill: Jom Jalan
5. Batu Cave: Capture the Wonders

SINGAPORE:
1. Gardens by the Bay: Sumfinity
2. Merlion Park: School of International Language
3. Universal Studio: H.I.S. Co.
4. Marina Bay Sands: Wikimedia Commons
5. Bugis: Asia Web Direct

THAILAND:
1. Phi Phi Island: Thailand Travel
2. Khao Yai: Wikimedia Commons
3. Grand Palace: Shutterstock
4. Khaosan Road: Shutterstock
4. MBK Center: Wikimedia Commons
